43	32																																									
9	9	9	9	9	9	9	9	9	9	9	9	9	9	9	9	9	9	9	9	9	9	9	9	9	9	9	9	9	9	9	9	9	9	9	9	9	9	9	9	9	9	9
9	8	8	0	0	0	0	0	0	0	0	0	0	0	0	0	0	0	0	0	0	0	0	0	0	0	0	0	0	0	0	0	0	0	0	0	0	0	0	8	8	9	9
9	8	8	0	0	0	0	0	0	0	0	0	0	0	0	0	0	0	0	0	0	0	0	0	0	0	0	0	0	0	0	0	0	0	0	0	0	0	0	8	8	9	9
9	8	8	0	0	10	0	11	0	0	10	0	0	11	0	10	0	11	0	0	10	0	0	11	0	10	0	0	0	0	10	0	0	11	0	10	0	0	11	0	8	9	9
9	8	0	0	0	0	0	0	0	0	0	0	0	0	0	0	0	0	0	0	0	0	0	0	0	0	0	0	0	0	0	0	0	0	0	0	0	0	0	0	8	9	9
9	8	0	0	0	0	0	0	0	0	0	0	0	0	0	0	0	0	0	0	0	0	0	0	0	0	0	0	0	0	0	0	0	0	0	0	0	0	0	0	0	9	9
9	0	0	1	0	1	0	1	0	1	0	1	0	1	0	1	0	1	0	1	0	0	0	1	0	1	0	1	0	1	0	1	0	1	0	1	0	1	0	1	0	9	9
9	0	0	1	0	1	0	1	0	1	0	1	0	1	0	1	0	1	0	1	0	0	0	1	0	1	0	1	0	1	0	1	0	1	0	1	0	1	0	1	0	9	9
9	0	0	1	0	1	0	1	0	1	0	1	0	1	0	1	0	1	0	1	0	0	0	1	0	1	0	1	0	1	0	1	0	1	0	1	0	1	0	1	0	9	9
9	0	0	2	0	2	0	2	0	0	0	0	0	2	0	2	0	2	0	2	0	0	0	2	0	2	0	2	0	0	0	0	0	2	0	2	0	2	0	2	0	9	9
9	0	0	2	0	2	0	2	0	0	10	0	0	2	0	2	0	2	0	2	0	0	0	2	0	2	0	2	0	0	10	0	0	2	0	2	0	2	0	2	0	9	9
9	0	0	2	0	2	0	2	0	0	0	0	0	2	0	2	0	2	0	2	0	0	0	2	0	2	0	2	0	0	0	0	0	2	0	2	0	2	0	2	0	9	9
9	0	0	3	0	3	0	3	0	3	0	3	0	3	0	3	0	3	0	3	0	0	0	3	0	3	0	3	0	3	0	3	0	3	0	3	0	3	0	3	0	9	9
9	0	0	3	0	3	0	3	0	3	0	3	0	3	0	3	0	3	0	3	0	0	0	3	0	3	0	3	0	3	0	3	0	3	0	3	0	3	0	3	0	9	9
9	0	0	3	0	3	0	3	0	3	0	3	0	3	0	3	0	3	0	3	0	0	0	3	0	3	0	3	0	3	0	3	0	3	0	3	0	3	0	3	0	9	9
9	0	0	4	0	4	0	4	0	4	0	4	0	4	0	4	0	4	0	4	0	0	0	4	0	4	0	4	0	4	0	4	0	4	0	4	0	4	0	4	0	9	9
9	0	0	4	0	4	0	4	0	4	0	4	0	4	0	4	0	4	0	4	0	0	0	4	0	4	0	4	0	4	0	4	0	4	0	4	0	4	0	4	0	9	9
9	0	0	4	0	4	0	4	0	4	0	4	0	4	0	4	0	4	0	4	0	0	0	4	0	4	0	4	0	4	0	4	0	4	0	4	0	4	0	4	0	9	9
9	0	0	5	0	5	0	5	0	5	0	5	0	5	0	5	0	5	0	5	0	0	0	5	0	5	0	5	0	5	0	5	0	5	0	5	0	5	0	5	0	9	9
9	0	0	5	0	5	0	5	0	5	0	5	0	5	0	5	0	5	0	5	0	0	0	5	0	5	0	5	0	5	0	5	0	5	0	5	0	5	0	5	0	9	9
9	0	0	5	0	5	0	5	0	5	0	5	0	5	0	5	0	5	0	5	0	0	0	5	0	5	0	5	0	5	0	5	0	5	0	5	0	5	0	5	0	9	9
9	0	0	0	0	0	0	0	0	0	0	0	0	0	0	0	0	0	0	0	0	0	0	0	0	0	0	0	0	0	0	0	0	0	0	0	0	0	0	0	0	9	9
9	0	0	0	0	0	0	0	0	0	0	0	0	0	0	0	0	0	0	0	0	0	0	0	0	0	0	0	0	0	0	0	0	0	0	0	0	0	0	0	0	9	9
9	0	0	0	0	0	0	0	0	0	0	0	0	0	0	0	0	0	0	0	0	0	0	0	0	0	0	0	0	0	0	0	0	0	0	0	0	0	0	0	0	9	9
9	0	0	0	0	0	0	0	0	0	0	0	0	0	0	0	0	0	0	0	0	0	0	0	0	0	0	0	0	0	0	0	0	0	0	0	0	0	0	0	0	9	9
9	0	0	0	0	0	0	0	0	0	0	0	0	0	0	0	0	0	0	0	0	0	0	0	0	0	0	0	0	0	0	0	0	0	0	0	0	0	0	0	0	9	9
9	0	0	0	0	0	0	0	0	0	0	0	0	0	0	0	0	0	0	0	0	0	0	0	0	0	0	0	0	0	0	0	0	0	0	0	0	0	0	0	0	9	9
9	0	0	0	0	0	0	0	0	0	0	0	0	0	0	0	0	0	0	0	0	0	0	0	0	0	0	0	0	0	0	0	0	0	0	0	0	0	0	0	0	9	9
9	0	0	0	0	0	0	0	0	0	0	0	0	0	0	0	0	0	0	0	0	0	0	0	0	0	0	0	0	0	0	0	0	0	0	0	0	0	0	0	0	9	9
9	0	0	0	0	0	0	0	0	0	0	0	0	0	0	0	0	0	0	0	0	0	0	0	0	0	0	0	0	0	0	0	0	0	0	0	0	0	0	0	0	9	9
9	0	0	0	0	0	0	0	0	0	0	0	0	0	0	0	0	0	0	0	0	0	0	0	0	0	0	0	0	0	0	0	0	0	0	0	0	0	0	0	0	9	9
9	0	0	0	0	0	0	0	0	0	0	0	0	0	0	0	0	0	0	0	0	0	0	0	0	0	0	0	0	0	0	0	0	0	0	0	0	0	0	0	0	9	9
